0 0 0 0 0 0 0 0 0 0 0 0 0 0 0 0 0 0 0 0 
0 5 5 5 5 5 5 5 5 5 5 5 5 5 0 0 0 0 0 0 
0 5 0 0 0 0 0 18 0 0 0 0 0 5 0 0 0 0 0 0 
0 5 0 0 2 0 0 0 0 0 2 0 0 5 0 0 0 0 0 0 
0 5 0 0 2 0 0 0 0 0 2 0 0 5 0 0 0 0 0 0 
0 5 0 0 2 0 0 0 0 0 2 0 0 5 0 0 0 0 0 0 
0 5 0 0 2 0 0 0 0 0 2 0 0 5 0 0 0 0 0 0 
0 5 0 0 0 2 2 0 2 2 0 0 0 5 0 0 0 0 0 0 
0 5 0 0 0 0 0 0 0 0 0 0 0 5 0 0 0 0 0 0 
0 5 0 0 0 0 0 0 0 0 0 0 0 5 0 0 0 0 0 0 
0 5 0 0 0 0 0 0 0 0 0 0 0 5 0 0 0 0 0 0 
0 5 0 0 0 0 0 0 0 0 0 0 0 5 0 0 0 0 0 0 
0 5 0 0 0 0 15 17 15 0 0 0 0 5 0 0 0 0 0 0 
0 5 5 5 5 5 5 5 5 5 5 5 5 5 0 0 0 0 0 0 
0 0 0 0 0 0 0 0 0 0 0 0 0 0 0 0 0 0 0 0 
