0 0 0 0 0 0 0 0 0 0 0 0 0 0 0 0 0 0 0 0 
0 0 0 0 0 0 0 0 0 0 0 0 0 0 0 0 0 0 0 0 
0 0 0 0 5 5 5 5 5 5 5 5 5 5 5 0 0 0 0 0 
0 0 0 0 5 0 0 1 0 18 0 1 0 0 5 0 0 0 0 0 
0 0 0 0 5 0 0 1 0 0 0 1 0 0 5 0 0 0 0 0 
0 0 0 0 5 0 0 1 1 1 1 1 0 0 5 0 0 0 0 0 
0 0 0 0 5 0 0 0 0 0 0 0 0 0 5 0 0 0 0 0 
0 0 0 0 5 3 3 0 3 3 3 0 3 3 5 0 0 0 0 0 
0 0 0 0 5 0 0 0 0 0 0 0 0 0 5 0 0 0 0 0 
0 0 0 0 5 0 0 2 0 0 0 2 0 0 5 0 0 0 0 0 
0 0 0 0 5 0 0 0 0 17 0 0 0 0 5 0 0 0 0 0 
0 0 0 0 5 0 0 2 0 15 0 2 0 0 5 0 0 0 0 0 
0 0 0 0 5 0 0 0 0 0 0 0 0 0 5 0 0 0 0 0 
0 0 0 0 5 5 5 5 5 5 5 5 5 5 5 0 0 0 0 0 
0 0 0 0 0 0 0 0 0 0 0 0 0 0 0 0 0 0 0 0 
